NO textures/test/north.png
SO textures/test/south.png
WE textures/test/west.png
EA textures/test/east.png

F 18,53,25
C 153,204,255

111111111111
1         11
1       0001
10S0000 0011
100000000001
111111111111
11         1
111111111111

